8 8
66666666
61111116
61111116
611oO116
611Oo116
61111116
61111116
66666666
