8 8
99999999
91111119
91111119
911oO119
911Oo119
91111119
91111119
99999999
