10 10
8888888888
8111111118
8111111118
8111111118
8111oO1118
8111Oo1118
8111111118
8111111118
8111111118
8888888888
