10 10
9173972876
6111111118
2111111112
3111111118
8111oO1119
3111Oo1114
9111111116
2111111115
3111111116
5222725827
