12 12
382826157719
511111111114
511111111115
611111111119
511111111117
11111oO11119
31111Oo11113
711111111111
111111111116
611111111115
411111111111
762513575228
